02010000000000000000
02000000000000000000
02000000000000000000
02010000000000000000
02010000000000000000
02010000000000000002
02000000000000000000
00000000000000000000
00000000000000000000
00000000000000000000
00000000000000000000
00000000000000000000
00000000000000000000
00000000000000000000
00000000000000000000
00000000000000000000
00000000000000000000
00000001010001010000
00000002101206020000
00000000081204000000
00000101091205010100
00000202020002020200
00000000010101000000
00000000020202000000
00000000000000000000
00000000000000000000
00000000000000000000
00000000000000000000
00000000000000000000
00000000000000000000
